BB...............................................................
.................................................................
.................................................................
.................................................................
.................................................................
.................................................................
.....P...........................................................
.....BBBBBBBBBBBBBBBBBB..........................................
.................................................................
.................................................................
.................................................................
.................................................................
.................................................................
BBBBBBBBBBBBBBBBBBBBBBBBBBBBBBBBBBBBBBBBBBBBBBBBBBBBBBBBBBBBBBBBB